==============
=S...........=
=............=
=............=
=............=
=...........E=
==============
