==========
=........=
=........=
=........=
=........=
=........=
=SE......=
==========
