======S=======
======.=======
======.=======
======.=======
======E=======
==============
